NO ./textures/mossy.xpm
SO ./textures/greystone.xpm
WE ./textures/colorstone.xpm
EA ./textures/eagle.xpm
   F  225,0,0
C 0,0,255
111111111111111111111111
11111111  111111111111111
1011000011110000000000001
100100000000000000000000111111111
111111111011000001110000000000001
10000000011000001110111000011111
11110111111111011100000010001
11110111111111011101010010001
11000011111111011100000010001
1000001     110000000011000001
10000011111111001101010010001
11000001110101011111000000N0111
11110111 1110101 101111010001
11111111 1111111 111111111111
